#####
# # #
#   #
# # #
#####