#################################################################################################################################################################
# #       # #     #     # #   #         #                     #   #   # # # #   #   # # #     # #   #           #     # #       #         # #     #       #   # #
# # # # ### ##### ### ### # # # ### ##### ######### ##### # ### # # ### # # # ### ### # ### ### # ### ### # ### # # ### ### ### ##### # ### ### ### ##### ### # #
#   # #   #       # #   # # #   #               #     #   # #   #                 #   #       #   # #   # # #   # #   # # #   #       #       #     #   # #     #
# # ### ##### ### # # # # # # # # # ### # ##### ### ### # ##### ##### ### ### # ### ### ####### # # # ##### ##### # ### # ### # # # # ####### ### ### ####### # #
# # # # #     #       #     # # # # #   # #   #   #   # #   #     #     # #   # # # #   #   #   #   # #           # #   # #   # # # # #   # #   #             # #
# ### ########### ################# # # # ### # ####### # ####### ##### ######### # ### # ### # ############# ### # # # # ### # # ##### ### ### # ##### ##### ###
#     #   # #       #     #   #   # # # # #     # #     # # # #     # #   #     #   #     #   # #     #       #   #   #       # #     #     #   #     # #   #   #
# ##### ### ### # ##### ### # # ##### ####### ### # ### # # # # ##### ### ##### # ### # ##### # # ######### ####### # ##### ######### # # ### ######### # ##### #
#       #   #   #   #   # # #   #     #       # #   #   #     # # # #   #             #   #   # #   #         # # # # #   # # # #   #   # # # # # #       # # # #
### ### # # ### ##### ### # # ### ##### # ### # # ### ####### ### # # ### ### ##### ######### # # # # ### ##### # ##### ### # # # ##### # # ### # ### # # # # # #
#   # #   #         #     # #   #     # #   # # #   # #     # #     #       #   # # #     # # #   #   #   #       # #   #   #         # #   # # #   # # #     # #
# ### # # ### ####### ##### ####### # # ### ### # ####### # # ##### ### ### ### # ##### ### # ### ### ### ### # ### ### # # # # ### ####### # # # ####### #######
#     # #   #     #   # #   #       # # #     # #     #   #   #   #     #   #         # #   # # # #   # #     #   #       # # #   # # #               # # # #   #
# ######### # ##### ### # ####### ########### # ##### # ##### # # # ### # ### ### ### # # # ### # # ### ##### # ####### ##### ### ### ### ########### # # # ### #
#     # #   #   # #     #       #   #   # # #     #   # #   #   #     # # #   #     #     # # # # #   #   #   # #     # # #   # # #   # #   # #   #   #         #
####### ######### # ########### ### # ### # ##### # ### # # # ####### # ####### ############# # ######### # # # # # # ### # # # # ### # ### # # ########### #####
# #       #   # #     # # # # #     #   # # #     #   # # # # #   #   # #       #   # #   #     #       #   # #   # # #   # # #   #       #   #     #           #
# # ####### # # ### ### # # # ### ##### # # # ### # ####### # # # ### ##### ### # # # ### ##### # ######### # ##### ### ##### ### # ### # # # ##### ##### # #####
#   # #     #   #         #     # #   #   # # # # # #       #   # # #   #   #     # #           # #   #     #     # #       # #   #   # # # #   #     #   #     #
### # # ####### ####### # ##### # # ##### # ### # ####### # ####### ##################### ##### # ### # # ### ### # # ### # ### ### ##### ######### ##### ##### #
#     #     #     # #   #     # # # # #     #   #   #   # #   # #         #         # # # #     #   #   #   # #   # # #   #   #       #       # # #       # #   #
# ##### # ##### # # # # # ### # # # # # ### # ######### ### ### # # # ####### # # ### # ### # # # ### # ### ############# # ##### ####### ##### # ### # # # ### #
#     # # #     #   # # # # # #     # # #       #               # # #       # # # # #   # # # #       # #   #   #     # # #   #       #     #   #     # # #   # #
### ############# ### ### # # ### ### # # ######### # ### ##### # ### ### ##### # # ### # ####### ######### # # # ##### # # ##### ####### ##### ######### # ### #
#     #                 # # #     #     #     #     # #     #   #   #   #   # # #   #   # # #     # #   # #   #     # # # #   #     #   # #   # #         #   # #
# ##### ########### # ##### # ### # # ####### # # # # # # ####### ### # ##### ##### # ### # ### # # # ### # ######### # ##### # ### # # ##### # ### # ### # ### #
#     #     #     # #   #   # #     #   #     # # # # # #     #   #   #         #         # #   # #     #   #           # #       # # # #     #     # #       # #
### # # ####### ### # ### ### ### ### ######### # # # ##### # # ### ######### ### # ####### ####### ##### # ### ### # # # ### ##### # ####### # ####### # ### ###
#   # #   #     #   # #     # #   # #         # # # # # #   # # #   # #   # # # # #       #       #     # #     #   # #   # # # #     # #   #   #       # # #   #
# ##### ### # # # ### ### ######### # # # ### # # # ### # ### ##### # # ### ### # # # ##### ####### # ### # ############# # # # ### ### # # ### ### ### ### #####
# #       # # # #   #   # #           # #   #   # #   # #   # #   # #           # # #           # # #     #           #         #     #   #       # #     # #   #
# # ### # ### ### ####### ### # ########### ##### # ### ####### # # ####### ##### ############# # # ### # ### ##### ### ### ####### ### ##### ##### ##### # # ###
#   #   #       #   # # # #   #   # #     #   #   #   #     #   # #         #     #   #               # # #     #   # # # # #   #     # #   #   # #     #       #
######### # # ##### # # # ##### # # ### ######### ### # ####### ####### ####### # # # ##### # # ######### # ######### # # # # ##### ### # ####### ### ####### # #
#     #   # #     # # #   #   # # # # #     #   #   #   #   #   #           # # #   #   #   # # #   #   # #   #     #     #   #   # #         #       # # # # # #
# # ### ####### # # # # # # ##### # # # # ##### # ##### # ##### ####### ##### ####### ############# # ### ####### ##### ##### # ### ### ######### # ### # # ### #
# # # #   #   # # # #   #   #     #   # #     # #     # # #   #   # #     # #     #   #   #       # #       #         # #     # # #       #   #   #   #         #
# ### ##### # ### # # ############# ##### ##### ### ### # # ##### # # ### # ### # ##### # # ##### # ######### # ############### # # ######### ##### # ### ##### #
#     #   # # # # # # #   #             #         # # #     #           #   #   #   # # #   #         # #   # #         #   #         #     #     # #   # # #   #
### ### ##### # ### # # ##### ### ##### # ### ##### # ######### # # ##### ##### # ### # # ######### # # # ### ### ##### # ######### # ### ##### ### ####### ### #
# # #       #   # #     #     #   #       #     # #       #   # # # #   #       # #     # #       # #   #   # #   #   #       #     #     #   #     # # # #   # #
# # # # # # # ### ##### ### ##### # ############# ### ### # # ### ##### ########### # ### # ######### # # # ### ##### ### ##### ########### ##### ### # # ### # #
#     # # # #         #   #     # #         # #       # # # # #     #     #         #   #     #   #   #   #   #         #           #   #       #     #       # #
### ##### # ######### # ############# # ### # # ####### # # ### ##### # # ##### # ### ### # ### ##### ##### ####### # ##### ########### ### ############# ### ###
# #     # # # # # #   #   #           #   # #   # #     #     #     # # #       # # #   # #   #   # #     # #   #   # #             #       # #       #     # # #
# # # ##### # # # # ############# ### ########### # ##### ####### ##### ##### # ### ####### ### ### # ####### ### ##### ### ##### ##### ##### ### ##### # # # # #
#   # # # #   #     # #     #       #     # #   # #   # #           #     #   #   # #   # # # # # #       #     #     # #   # #     #       #     #     # # # # #
# ##### # ### # ### # ### ##### # ######### ### # # ### ####### # # # ####### # # # # ### ### # # ### ##### # # ### ######### # ##### ######### ####### ####### #
# # # #     #     # #       #   #     #   #   # #   #     #   # # #       #   # # #       #   #         #   # #   #   # #     # #       # # # #         #       #
# # # # # # # ### # # ##### ### ######### # # # # ##### # ### ### # # ####### # ####### # # ############# ### # ### # # ##### ### # ##### # # ### ############# #
# #   # # # # #   #   #   #       #       # # #       # # #       # #     #   #   # #   #             # # #   # #   #           # #       # # #           #     #
# ### ##### ### ### ##### ### ### # # ##### ####### # # # # ##### ### # ####### ### ######### ######### ### ####### # ####### ### ######### # # ### ### ### # # #
#     # #   # # #   #     # #   #   #     #   #   # #   # # # # # # # # # #     #     # #   # #     #     #   # # # #   # #     #       # # #   # #   #     # # #
### ### ### # # ### # ### # ##### ##### ### ### ####### ##### # ### # ### # ### ### # # ### # ### ### ### # # # # # # ### ### ####### # # # ##### ######### #####
# # #   #         #     # #     # # #   #   # # # #       #       #   #   #   #     # # #   # # #     #     #       # #     # #     # #   #       #   #         #
# # ### # ### ##### ######### # ### ### ### # # # ### ### ### ### ### # # ##### ### ### # ### # ##### ### # # ### ### ### ### # ####### ### ### # # ####### ### #
#       # # #   # #   #   #   #   #         #     #   #   # # # # #     # #     # # #       #         #   # # #     #       # #   #     # # #   # #           # #
# ### ### # ##### ####### # ######### ### ### ### ### # ### ### # ############# # ####### ### # ##### # ### # ##### ### ### ### # # ##### ##### ##### ### # # ###
# # #   #       #   #   #       #     # # #     #   # #         #           #       #         # #     # # # # # # # # #   # #   # # #         #   #   # # # #   #
### # ############# ### # ### # # # # # # # ######### ### # ### ##### ##### # # # # ##### ### ##### # ### ##### # # # # # ### ##### # ########### # ### ####### #
# #                 #   #   # # # # # #     # #   #   #   #   #   #   # #   # # # #       # # #   # #   #   #     # # # #   #     # #   #     # #   # # # #   # #
# ### ### ### ### ### ####### # ### ######### # # ### ####### # ####### # ####### # ### # # # # ##### ### ### # ##### # # ### # ### # ### ### # # # # # # ### # #
#       # #   # #       #   # # #       #   #   #     # #     #       # #         #   # # #     #     # #     #   #     # #   # #     #   # # #   # #     #     #
### ### # ##### ### ####### # ##### ####### # # ##### # # ##### # ### # ##### # ### ######### # ### # # ######### # ### ### ### ### # # ### # # # ####### ##### #
#   #   #   #   #   #       #     #   # #   # #     # #     # # # #           #   # #   #     #   # #     #   #   # #     #   #   # #   #     # #   #     # #   #
### ##### ##### # # ### ### # ####### # ### ### ####### ##### # ### ### ##### ######### ##### # ### # ##### ##### ### # # # ##### # # ##### ####### ##### # #####
#   # #     #     # #     # #     #   #     #   #     #   #   #   # #     # # #     # # # # # # #   # #     #     #   # # # #     # #   #   # #     #           #
# ### ######### ### # ### ### ##### ##### ####### ### # # ### # # # ### ### # ### ### # # # ##### ### ### # ### # ##### ##### ####### ##### # ### ##### # # ### #
#   #     # # # #   # # #       # # # #         # # # # #   # # # # # #     #   #   # #       # # #       #   # #   #     #     # #       # # # #   #   # # #   #
##### ### # # # ### ### ####### # ### ### ######### # ##### # ####### # # ####### # # # ####### # # ############# ####### ##### # # ##### ### # # # ### # ### ###
#   #   # #     # #         # #   # # #   #   #     # # #       #     # #   #   # #     # #   #   # # #         #       #     # #   # #           # # # # # #   #
# # # ######### # ##### # ### # ### # ### ### # # ### # # # ### ### ### ### # # ### ### # ### ### ### # # # ##### ######### # # # ### # ### ##### ### # ### ### #
# #       #       # #   #   # #   #     #     # # #   # # # #   #     #   # # #     #   #     #       # # #         # # #   #       #     #   # #     #     #   #
####### # # ##### # # ### # # # ### ### # ##### ### ### # ########### # ### ########### ### ######### ### # ##### ### # # # ### # ##### ##### # # ####### # #####
#   #   #   #     #     # #       # # #     # #     #     #     # #     #     #     #                 # # # #   #   # #   #   # # #     # #     #   #     #     #
# ##### ####### ##### ######### # # # ##### # # ### # # ####### # ##### ##### ##### # ##### ##### # ### ### # # ### # ##### ####### # ### # ################# ###
#             # #   #     #     #   # #     # #   # # # #     #   #       #   #   #     #   #   # #       #   #   #   # #         # #   #   #   # #       # #   #
# ### ### ####### # ### ############# ### ### ### ### # # # # # ### ######### # ### ### ### # ### ### ### # ### ##### # ##### ### # ########### # ####### # # ###
# #     # # #   # # # # #       #     # # #   #     # # # # #   # #         # #       #   #   # # # # #     #   # # #   # #   #   #     #   #   #     #   # #   #
### ##### # ### # ### ### ### ##### # # # # ##### # # ####### ### ### ##### ### ##### # ### ### # # ### ##### ### # ### # ######### ##### # ### # ##### # # # ###
#       # #     #           # # #   # # # #   #   # #         #   #     #   # # #   # #   #   #   #     #             # # #               # # #   #   # # # #   #
# # # # ####### # ### ### # # # ### # # # ### # ##### # ### ##### # ####### # # # # # # ####### ### ### # ####### ### # # ### # ### ######### # ##### ### # ### #
# # # # #       #   # #   # #   # # #         # #   # # # #     #     #     #   # # # #   #   # # # #   #     #     # #     # # #       #     # # #   #         #
############# ####### ########### ### ### ### # # ### ### ### # ##### # ##### ##### # # ### # # # # ##### ####### ### ### ##### ####### ### ### # # ### # #######
# #     #         # #       # # #       #   #   #           # # #   # #     #   #   # # # # #   # # # # #     #     # #   #       # #     #     #       # #     #
# ### ### ### ### # # # # # # # ##### ### ### ### ### ######### # # ######### ### # # # # # ##### ### # ### ### # ########### # # # ######### ##### # # # # ### #
#   #     #     #     # # # #   # #   # # #   # # #         #   # # #       #     # # # #   #   #         #   # #   #       # # # #     #   #   #   # # #     # #
# ### ### ####### # ####### ### # # ### ####### ### ######### ### # ### ####### ### ####### # ##### ####### ######### ##### ####### ### # ### ### ########### ###
#   # #   # # #   #   #     #     #         # # # #   # #       # #   #   #       # #   #     #       #     #     #   # # #       # #   #   #   # # # # #       #
# ### ### # # ### # ########### ##### ####### # # ##### # ##### ##### ### # ########### # ##### # ####### ##### ### # # # ##### # # ####### # ##### # # # #######
#     #   #   #   #   # #   #           # #     # # # #   # # # # # #     #     #     # # #   # #               # # #   #     # #   #   #       #   #     # # # #
# ##### # ### ### # ### ### ### # ### ### ### ### # # ### # # ### # # # # # ### ### ### # ### ######### ### ##### # # ##### # ### ### # # ### ##### # # ### # # #
#   #   #   #     #     # # #   # # #   #       #       #   # #       # # # #   #     # #   # #   #     #     #   # #   #   #   #   # #   #     #     #   #     #
# ### ####### ### # ### # # # ### # # # # ##### ##### ### ### # ### ##### ######### # # # ### ### ### ##### # # ##### ####### ############# ### ### ####### ### #
#   # # #   # #   #   #   #   #   #   #   # # # #       #     # # # # #   # #   # # #   #     # # #     # # #   #   # # #       # # #     # #             # #   #
### ### # ### ########### ##### ### # # # # # ### ######### ##### # # ### # ### # # # ######### # ####### # # # # ### # ### # # # # # ##### ######### # ####### #
#   # # # # #   # #   #   #   #   # # # # #   # #   #     # #       # #     #     # #       # #     #       # # #       #   # #     #           # #   # #   #   #
##### # # # # ### # ####### # # ####### ##### # ### # # # # ######### # ### ### ### ### ##### # # ### ####### # # # ### ####### # ### # ### ##### ### ### ### ###
#       #   #   #         # # #     # # # # #   #     # #   #     #     #   #   # #   # #   #   #   #     # # #   #   #     # # # # # # # #     #   #     #     #
# ##### # # # ##### ####### # # # ### # # # ### ########### ##### ####### # # # # ##### ### ####### ### ### ### # # ### ### # ### # ##### ### # # ### ### # ### #
#   #     # #             # #   # #         #       #   #     #   #     # #   # #             #       #     # # # # #   # # #       #         # #   # #   #   # #
# ### ########### ### ####### # # # # # # ### # # # # ##### ##### # # ######### # # ##### ### ####### ### ### # ##### ### ##### ##### ##### ##### ### ####### ###
# #           # #   # # # # # # # # # # # #   # # #   #   # #       #     #       #     # # #   #   #         #     # #     #   #     #   #   #       #     #   #
######### # ### # # # # # # ####### ####### ### # ##### # ############# ### # ### ######### # ##### ##### ### ####### ### ##### ### ### ####### ##### ##### # ###
#   # #   #       # #           #             # #   #   #   #     #     #   # # # # # # #   #       #   # #   #       #       #     #     # #       #           #
# ### ######### ####### # ##### # ####### ### ########### ##### ##### # ##### # ### # # ### # ####### # # ######### # ##### ####### ##### # ### ### # # ####### #
#     #       # # #   # #   # #   # #       # #         #     #     # #   #   #   #         # #       # # #   #     #           #         # #   # # # # #   #   #
# ##### ######### # ##### ### # ### ######### # # ####### ### ### ### # ##### # ######### ### ####### ### # ### ### ##### # ######### ##### # ### ######### # # #
#     #   # #   # # #       # #   #     # #   # #     #   #     #     #           # #     #   #   #           # # #     # # #     # #     #   #   # # #     # # #
# ### ### # ### # # # ### ### ### ### ### # # # # ##### # ##### ### ### ##### # # # ### ### # # ####### ### # # # ############# ### ### ### ##### # # # ####### #
# # # #     #   #       # #   #       #   # #   #   # # #   #   #   #       # # #         # # #     #     # # # # #     #         #       #         #         # #
# # # ##### # # # ######### ### ####### ### ##### ### # # ### ### # ### # # ### ##### # # ### # ##### ####### ### # ########### ### ####### ####### ### # ##### #
#   #       # # #     # #       # # # # #   #   # #     # #       # #   # # #     #   # # # #   #   # #       #           # #         # #   # #     #   #       #
# ##### ### # ### ##### ### # # # # # # # ##### ### ######### ##### # ##### ######### ##### # # ### # # # # ### ### ####### ######### # ##### ####### ### ### ###
# #       #     # #   #     # # #   # #   #   #     #   #   #     # #     #   #   # #     # # # # #   # # # #     # # #     #   #   # #       #   # # #     # # #
# ############# # ### # ######### # # # ### ### # # # ##### ##### ############# ### # # # # ##### # # ########### ### # ##### ### # # # ##### ### # ### ####### #
#   #   #             # # # # #   #   #         # # #           #       #     # #   # # # #     #   #       #     # #         #   # #     # #     # #     #     #
# # # # # # ##### ####### # # # ### ### ######### ####### # # ##### ######### # # ##### ##### # ### ##### ##### ### ####### ##### ####### # ##### # ##### ### ###
# # # #   #   # #     # #         # # #     # # # #   # # # # #       #           #   #   #   #   # # # # #   #   #   # #   #   #       #     #   #     #   # # #
### # ##### ### ### # # ######### ### # ##### # # # # # ##### ### ### ####### # ##### # # ### ### # # # # # ### # ### # # ### ### ### ### ### ##### # ### ### # #
# # # # # #       # #   #   # # #               #   # #   # #   # #       #   #         # #     #     # # #   # # #   #   # #     # #   # #   #     # #       # #
# ### # # ##### ########### # # # # # # ### ##### # ##### # # ####### # ####### ### ### ##### ##### ### # # ### ### ##### # ####### ### # # ##### ### ######### #
#     #   #   # #         #   #   # # # # #     # # #           #   # # #     #   #   #     # # #       #   #   #       #   #         #   # #   # #         #   #
# # # # ### # # # # ### ##### # ######### # ### # ### ####### # # # # ### ##### ##### # ### ### # # ### ### # # # # ### # ##### ##### # # # ### # ### ######### #
# # #   #   # # # #   #   #     #         # #   # #     #     # # #     #     # #     # #   #     # # # #     #   # #     # # # # #     # # #     #             #
##### ### ####### ### # ####### ####### # ####### ########### # ##### # # ### # ### ####### ##### ### ######### ##### ### # # ### ##### # # # # # # ##### # #####
#     #   # # # #   # #   #         #   # #   # #   # # #   # # #     # #   #   #         #     # # #       #     #     # # #     #     # #   # # # #     #   # #
# ##### ### # # # # ### # # ### ##### # ### # # ### # # ### ### ### ############# # ####### # ### # # ########### ####### # ##### # ########### ##### # ### ### #
# #   #           # #   # # #     #   #   # #   #   #       #     # #     # # #   # #     # # #     #         # #   #   #   # # #       # #         # # # # #   #
# # ####### # ### # ### ####### ####### ####### ##### # # ####### ##### ### # ##### # ##### ### ####### ### ### # ### ####### # ### # ### # # ####### # # # ### #
# # # #     # #   # #     #         #       #     #   # #           #       #   #   #     #       #   # #       #           #       #   #   #   #   # #   # # # #
# # # ### ### ####### ########### ##### # ##### ### ##### # ####### # # ### ### ##### # # ### ### # ### ### ####### ### ### # ### ### ####### # # ### # ##### # #
#     # # #     #   #   # #   #     # # # #     #   # # # #   #       #   # #   #   # # # #     # #     # # #     #   # #     # # #     #     #     # # # # #   #
# ##### ##### # # # # ### # # ### # # # # # ####### # # ### ############### ### # ### ### # # ### ##### # # ### ### ####### ### # ##### # # ######### ### # # # #
# #     #     # # #   #     #   # # # # #         #     #   # #   # # # # # #         # #   # #   # #     #   #   #   #   # # #   # #   # # #   # #           # #
# # # ### ####### # ####### ##### ### # # ####### ######### # ### # # # # # ##### ### # ####### # # # # ### ### # # # # # ### ### # ####### ### # ####### # #####
# # #     #     # #         #       #   # # #     #     # #     #   # # #   # # # #       #     #     #   # # # # # #   # #       # #             #       #     #
# ####### # ##### # # # # ### ##### ### # # ### ##### # # # ##### # # # # ### # ####### ### ### ##### # # ### # # ##### ##### # ### # ########### ##### ####### #
#   #     #     # # # # #       #       # # # #     # #   #     # # #       # #     #   #   #     #   # # # #   #       #   # # #   # #     #   #   # # # # #   #
### ##### # # ############# ####### # ### # # ### ##### ####### ### ### ##### # ##### ### ############### # ##### # ### # # ##### ######### # ### ### ### # # # #
#       # # #         #   #     # # # #     #         # #       #   # #   #   #       #       #   #           #   # #     # # #         # # #         # # #   # #
### ### # # ######### ### ### # # # ####### ### ####### ##### ### ### # # ### ####### ### ####### # ##### ##### ############# # ####### # # ### # ##### # # #####
# #   # # # #     #           #   #     # # #     #   # #   #   # #     # # #     # #   # # #   #   #     #     #   #             #   # # #     #   # # # #     #
# ### ##### ### ### ### ### # # ### ##### ####### # # # # # # # # ##### ### ### ### ####### ### ### ##### # ### # # ######### # # ### # # ### ##### # # # #######
# # # #   # #   # # #   # # # # # # #       # #   # # #   #   #   #     # #   #           #   # #   #     # # # # # # #   #   # # #         # #   # # #   #     #
# # ### # # # # # # ### # ##### # # # ####### # ### ######### ##### # ### ### ####### # # ### # ##### ##### # # ### # # ##### # ### # # ##### # ##### ### ##### #
# #   # # #   #   # #     # #   # #       # #         #         # # #         # #     # #   #     #       #   # #           # # #   # #             #   #       #
# # ### # ### # ### ##### # # ### ######### # # ####### ##### # # # ##### ### # # ####### ####### ######### # ### # ############# ### ### # ##### ### ##### # # #
# # # # #     # #   #     #       # # #     # # #     #     # #   # # # # #   # #   #   # #           #   # #     #       #   #   #   #   #     #   #     # # # #
# # # ### ######### # ### ####### # # # # ##### ### ### ### ##### ### # ### # # # ### ##### ### ### ### ### ##### # ######### # ##### ##### ########### # # ### #
#             #   # # #         #       #     # # #     #     #   # #     # # #   # # #     # # #         # #   # # #     #         #   #     #         #     # #
# # # # ####### ########### # ############# ##### # # # ### # # # # ##### # # ### # # # # ### # ######### # # ### ### ##### ####### ##### ##### ### ### ### ### #
# # # # #   #   #     #     # #     #   #   #   #   # # #   # # #   #       #           #   #       #       # #       #       #   # #     # #   #     # # #   # #
# # ### # ### ##### ### ### # ### # # # ##### ##### # ### # ### ########### # # ### ### # ##### # ##### # ### ####### # ### ### # # ####### # # ### # # # # ### #
# # # #   #   #   #       # # #   #   #           # # #   #   # #   # #   # # # #   # # #   #   #   # # #   #         # # #   # #             #   # # # #   # # #
##### ### ### ### # # # # ####### # ### ### ### ##### # # ######### # ### ########### ### ### ### ### # ##### ########### ####### ### ####### # # ##### # # # # #
# #   # # #   # #   # # #     #   #   # # # #     #   # # # # #       # # #     #   # # #   # #     #   #     #   # # #     #     #   #   #   # #   #   # #   # #
# # # # # # ### ##### # ####### ### ### # ##### ##### # ### # ####### # # # # ##### # # ##### ### ##### ##### ### # # # ##### ######### ##### # ### ######### # #
#   #       #         #       # #     #   #           #                   # #                   #   #   #               #         #           #   #       #   # #
#################################################################################################################################################################