#####################################################################################################
#     #     #   #             # # #   # # #       #         # # # #   #   # #     #     #       # # #
### # # # # ### # ### ##### ### # ### # # # # # ##### ##### # # # # # ### # # ### # ### ### # ### # #
#   #   # #   #     # #       #   #     #   # #   #   #         # # # #     #   # # # #     # #     #
##### # # # ####### ##### ##### ### ### ######### ### ### ####### ### # # # ### ### # ##### # ### ###
# #   # # #   #       # #   #       #       #   #     #   #     #     # # #           #     #     # #
# # # ####### ### # # # ##### # ### # ##### # ### # # # # # ##### ########### ##### ##### ######### #
#   # # #     #   # # #   #   # # # # # #         # # # #               # #   # #     #   #       # #
### ### # # ### ### ##### ####### # ### ### # ### # ### ######### ##### # # ### ####### ##### ##### #
#   #   # # #     # #   #   #     # # #     # #   # #     #     # #                 # #   #       # #
# ### # ### # # ### # ### ##### ### # ################### ##### ### # ####### ### # # ########### # #
#   # #       # #         #   #   # #       # # #     #     #     # # # # #   #   #   # # #         #
##### # ####### ### # ##### ### ### # # ### # # ### # ########### # ### # ### ##### ### # ### # # # #
# #   # #   #   # # #           # # # #   #     # # #   #   #       #     # # #     # #     # # # # #
# # ####### # ### ######### # ### # # # ##### ### # # # ### ##### # # ### # # # ### # # ### ##### ###
#         #   #     #       # # # # # # # #     # # # #     #     # #   #   # #   # # # #   #     # #
# ### ##### ### # # # # ####### # # ##### ### # # ####### ######### ### # ### # # # # # ##### ##### #
#   # # #   # # # #   #     #     # #         #   #         #     # # # # #   # # # #       #       #
####### # # # # ##### ### ##### # ########### ######### ##### ##### # # ######### ##### ##### # ### #
#   #   # #   #   # # #   #     # #               # # # # # #     #   #       #   #     #   # #   # #
# # ### ### ### ### # ### # ### ### ##### ### ### # # # # # # ### # ####### ##### # ####### ### # ###
# #           # # #   # # # #     # #   # # # #   # #     #   #       #     #           #   #   #   #
# ##### ### # # # ##### # ####### ### # # # # ### # ##### ##### ### # ##### ### # # ####### # # # # #
# #   #   # # #   #   #   # #       # # # # # # #         # #   #   #   # # #   # #   #       # # # #
##### ####### # ### ####### # ######### ### ### # # ### # # ##### # ##### # ### ### ####### #########
#   # # #     #   #       #         #       #     # # # #   #   # # # # # #   # #   #   #   # #     #
# # # # # # # # # # ####### # ### ######### # ####### # # # # ##### # # # # ######### ### # # ### ###
# # # #   # # # #     # # # #   # #   #         # # # # # #           # #     # # #     # #   # # # #
# ### ### ### ######### # ### ### # # # # ##### # # # # ##### ##### # # # # ### # # # # ### # # # # #
# # # #     #   # #     #       #   #   # #     #   #       # # # # # #   #     #   # #     #   # # #
# # # # # ### # # ### ##### ########### ####### ### # ##### # # # ### # # ####### ### ########### # #
# #     #   # # # # #     #     #       # #   #   #       # # # #     # # # #       #   #     #     #
# # ##### ##### # # # ##### ####### ### # # ### ##### ######### # # # ### # ##### # # # # ### # # ###
#   #         #   #   #     #         #   # # #   # # #       # # # #       # #   # # #     #   # # #
### ##### ######### ############# ##### ### # # ### # # ### # # ### ##### ### # # ##### ##### # # # #
#   #       # #             #   # # #         #   #     #   # #     #     # # # #   #   #     # #   #
### # # ##### # ########### ### # # ####### ### # ##### ### ### ####### ### # ##### # ##### # # # # #
#   # # # #   #     #                   #     # # #     # # # #       #           # # #     # # # # #
# ####### # ##### ####### ####### ####### ########### # # # # ### # ################### ### # # # ###
#       # #   #       #         #     #   #       #   # #   # #   #   #   # #           #   # # #   #
# # # # # ### # ### # ####### ####### ### ### ### # ### # ### ##### ### # # ### # ### ####### ### ###
# # # #         #   # #       #     #   #     #   # #   #         #   # # #   # #   #   #   # # #   #
### # ### ### ##### ### ### # ##### ######### ############# ### # ### # ### ### ### ### # ##### # ###
#   #   # #       # #   #   #   #     #     # # #       # # #   # #       # #   #   #   # #       # #
### # ##### # ### ### # ### ### ##### # ####### ####### # # ############# # # ### ##### # # # ### # #
#   # #     #   # #   #   # # #   #     #   # #   #       # #   #     #   #   #     #   # # #   # # #
# ### ### ########### # ##### ### # ### # # # # ######### # # ####### # ########### # # # ##### # # #
#   # # # #         # #   # #       # # # #   #     # #     #   # #     #     #   # # #     # # #   #
# # ### ### ### ####### ### ### ### # ####### ### ### ### ### # # ### ### # # ### ### ### ### # ### #
# #     #   # #   # #         # #   #   #               # #   # # #       # #       # # # #   # # # #
# # # # ##### # # # # ### ######### # ##### ##### # ### # # ### # ### ### # # ### # # # # ### ### ###
# # # #   #     # # #   #   # #   # # #   # # #   # #   #   #   # #   #   # # # # #   #       # #   #
# ### ##### # # ### ##### ### ### # # ### # # ####### ####### # # ####### # ### # # ##### ##### ### #
#   # #   # # #   #   # #       # #     #   #   # #   #       # # # #   # # #     # #     #     # # #
##### # # ### # ##### # ### ##### # ##### # ### # ### ##### ##### # ### # ### ######### # ##### # # #
#   # # # #   #   #   # # #     #     #   # #   #   #     # #   #       # # #   # # #   #   #       #
# # ### ### ##### # # # # # ##### # # # # # # ### ######### # # # ### # ### ### # # # # # ##### # # #
# #       # # #   # #           # # # # # #   #       #       # # # # #   #       #   # #   #   # # #
### ### # ### # ### ######### # # ####### # ### ####### ### ##### # ######### ########### ##### ### #
#     # #     #         #     # # #     # #       # # # # #     #     # # # # # # # #     #   # #   #
# ##### ########### ##### ####### ### ### ##### # # # ### ### ### ### # # # ### # # ##### ### # ### #
#   # #       # #       #       #   #     # #   #   # #       #     #     # #           #   #     # #
# ### # ##### # ##### ##### ####### # ### # # ####### # ##### ##### ### ### ### # # # ### ####### # #
# #     # # #     # #   #     #       #   #       #   # # #       #   # #     # # # #     # #   # # #
##### # # # # ##### # # ######### ####### # # ##### # ### ######### ####### ####### # ### # ### ### #
#   # # #   # #     # # #   #       # #   # #     # # #   #     #     #       #   # # #       # #   #
# ##### ### # # ### ####### ######### ##### ####### # # # # ######### ### ####### # # ### # # # ### #
# # #     # #     # #         #   # #         #     #   #   #         #     #   #   #   # # #       #
# # ##### # # ####### ### # ### ### # ### ### # ### # ### ####### ### # ### ### # ####### ### ##### #
# # # #   # # #       #   # #     # #   #   # # # # #   # #   # #   # #   # #       #   #   #   #   #
# # # ### # ### ### ### ######### # ####### # # # ### ##### ### ##### # # ##### # # # ##### ### ### #
# #       #     #     #       #   #   #     #     # # #     #     #     # #     # #     # # # # # # #
# # # # # ##### ### ######### # # ### ### # ### # # # ##### ##### ####### # ############# # # # # # #
#   # # #       # #   # #     # # # # #   # # # #   # # #   # # #           #       # #     # #   # #
# ####### ##### # # # # # ### # # # # ##### # # # ##### ### # # # # ########### ### # # ##### # #####
#     #     # # # # # #   #   # #     #       # #   # # #       # #     # #   # #   # #   #   #   # #
# ### # ##### ### # ### ### ##### ### ### ### ### # # # # ############### # ##### # # ### # # ##### #
# #   #   # #     # # #   #     # # #   #   # #   # #     #   #     # #     # #   #   #   # #   #   #
### # ### # ##### # # # # ### ### # ### ### # ######### ##### ##### # # ##### ##### ####### ### ### #
#   # #   #           # # #     # #       # #   #     # #     # #         # #   #   #   #   # # #   #
############# # ##### # # ### # # ### # ### ##### ##### ### ### # ### ##### ### ### ### ##### # ### #
#     #   # # # # #   # # #   #     # # #   #       #   #     # # #     #       #         #         #
# ### ### # ##### # ### ### ####### ### # ######### # # # # ### ### ##### ##### # # ##### # ##### ###
# # #   # #   #     # #   #       # # #     #     #   # # #     # # # #     # #   #   # # #   #   # #
# # # ### # ######### # ### ######### # ####### # # ########### # # # # ##### # # ### # # ##### # # #
#   #   #   #     # #     #           # #     # # #   #           #         #   #   # # #     # #   #
# ### ### # # ##### # ####### ########### # ##### # ### ### # # ####### # ############# # ### # ### #
# # #     #   #   # #       # #         # # #             # # #   #     # # # #   #   # #   #   #   #
### ### # ### # ### # ##### # ### ### # # ##### ### # # ### # # ### ##### # # # ##### # # ### # #####
#       #   # #           # #   # # # #       #   # # # #   # # # # # #       #     # #   # # # # # #
# ##### ####### # ####### ######### # # # ### ####### ##### ##### # # ####### # ##### # ### ### # # #
#   #     #     # #     #     #     # # #   # # #   # #   #   #         #             #     #       #
### # # # ### # ####### ### ##### ####### ##### # ### # # # ### ### ############# ##### # ### # ### #
#   # # # #   # # #             # #   #   #             # #   # # #   # #   #   #     # #   # # # # #
# ##### ##### ### ######### ### # ### # ######### ### ### ### # # ##### ### ### # ##### ####### # # #
#   #     #   #   # # # # # #       #   #           #   #   #       #       #         # #   #   #   #
# ####### # ### # # # # # ##### # # # ### # # # ########### # # # ### ### # ##### # # # ### # ### ###
# # #     #     # #       #   # # # #   # # # # #           # # #   #   # # #     # # #   #   # #   #
# # ######### # ##### ### ### ##### # # # ##### ##### ### ##### # ######### ### ####### # ##### #####
#   # #       # #   #   # # #         # #   #   # #     # #   # # #   # # # #   # #   # # #   # #   #
# # # # # ####### # ### ### # ### # ### # ##### # ######### ##### ### # # # # ### ### ####### # ### #
# # #   # # #     # #     # #   # # #         #     #       # # #     # # #   #     #     #   #     #
# # # ##### ### ### ### # # ####### ### # ####### ### ##### # # ####### # # # # ### # ####### ##### #
# #     #   #   #     # # #           # #   # #     # # # # # # #   #     # #   #   #             # #
### ##### # # ##### ### ### ### ##### # ### # # # ### # # ### # # ### # # ### ##### # ########### # #
#   # #   # # #       #     #     #   #   # #   # #         #   #     # # #     #         #     #   #
# ### # # # ##### ### # # ####### ############# # # ##### ##### # ### ####### ### ### ### ### # # # #
#   # # # # # # # #     # #     #   # # #     # # #   #   # # #   #   #   # #   # #   #     # #   # #
# ### # # ### # ### # ##### # ####### # # # ##### # # # ### # ### # # ### # # ### ### ######### ### #
# # #   #   #   # # # #   # # # # #     # # #     # # #     #   # # # # #   # # # # # #     # #   # #
# # ####### # ### # # ### # ### # ### ##### ### ####### # # # # # # # # # ##### # # # # ### # ### ###
# #   #         #   #   #   #   #   #   #   #     # #   # #   # # # # #   #       #     #       # # #
# ### ### ### ##### ### # ##### # ### # ### # # # # # # # # # ### ####### ### # # ##### ########### #
# # # # # #   # # # #   # #     #     #       # #     # # # #     #     # #   # #     #   # # #     #
### # # ### ### # ### ### ### ####### ##### ################### ##### ### # # # ####### ### # # # # #
#     #     #         # # #   #     # #   #     #     #   # #     #     # # # # #   #       #   # # #
# ### # ### ####### ### # # # # ### # # # ### # ##### ### # # ### # ### # # ##### # # ### ### ### # #
# #     # #               # # #   # #   # # # # #   # # #   # #   # #   #     #   #     # #   # # # #
### ### # ####### ##### # # ### # # # ### # ### ### # # # ### ### ### ############# # # ### ### ### #
#     #       #     #   # #     # #     #     #     #           #       #           # #         #   #
#####################################################################################################