#####################################
#       #   #     #         # #   # #
# ##### # # # ### # ### ### # # # # #
# #   # # # #   # # #   #     # # # #
# # # # ### ### # ### ####### # # # #
# # # #         #   #       #   # # #
# # # ########### # ####### ####### #
# # #   #       # #       #   #     #
# ### # # ####### ####### # # # #####
#     # #     # #       # # # #     #
# ### # ##### # ####### # ### ##### #
#   # #     # #       # #         # #
########### # # ##### # ######### # #
#         #   # #   # #       # # # #
# # ######### ##### # ####### # # # #
# # #           #   #     # # #   # #
# # # ######### # ####### # # # ### #
# # #   #   #             # # # #   #
### ##### # ######### ##### # ### ###
#       # # #       #   #   #   #   #
# # ##### # ##### # ### # # ### ### #
# #       #       #       #   #     #
#####################################