#################
#       #     # #
##### ### ### # #
#         # #   #
### # # ### ### #
#   # #   #   # #
# ### ####### # #
#   # # #   #   #
# ### # # ##### #
#   #   #   #   #
# ####### ### # #
#   #         # #
# # # ######### #
# # # #         #
### ### ### # # #
#     # #   # # #
#################